1111111111111
1E010000000C1
1000C11111001
1P0011E000001
1111111111111
